00018100000000000000000000000000000000000000000
00011100000000000000000000000000000000000000000
00011100000000000011111111111111111100000000000
00011100000000000012111111111111112100000000000
00011100000000000011111111111111111100000000000
00011100000000000011100000000000011100000000000
00011100000000000011100000000000011100000000000
00011100000000000011100000000000011100000000000
00011100000000000011100000000000011100000000000
00011100000000000011100000000000011100000000000
00011100000000000011100000000000011100000000000
00011100000000000011100000000000011100000000000
00011100000000000011100000000000011100000000000
00011100000000000011100000000000011100000000000
00011100000000000011100000000000011100000000000
00011100000000000011100000000000011100000000000
00011111111111111111100000000000011100000000000
00012111111111111112100000000000011100000000000
00011111111111111111100000000000011100000000000
00000000000000000000000000000000011100000000000
00000000000000000000000000000000011100000000000
00000000000000000000000000000000011100000000000
00000000000000000000000000000000011100000000000
00001111111111111111111111111111111100000000000
00001211111111111111111111111111112100000000000
00001111111111111111111111111111111100000000000
00001110000000000000000000000000000000000000000
00001110000000000000000000000000000000000000000
00001110000000000000000000000000000000000000000
00001110000000000000000000000000000000000000000
00001110000000000000000000000000000000000000000
00001110000000000000000000000000000000000000000
00001111111111111111111111111111111111111111111
00001211111111111111111111111111111111111111119
00001111111111111111111111111111111111111111111
00000000000000000000000000000000000000000000000
00000000000000000000000000000000000000000000000
00000000000000000000000000000000000000000000000
